000000000000000
000000000000000
000000000000000
000000000111000
000000000000000
000000111100000
111000000000000
001000000000000
000000000000000
000000000000000
000000000000000
000000111001111
111000011000000
001000001000000
000000000000000
000000001000000
000000001100000
000100000000000
000100000000000
000100000000000