000000100000000
000000010000000
000000100000000
000001000000000
000110000000000
000000000000000
000000000111111
000000000000000
001000000001000
001000000000011
001000010000111
000000010101000
000000010000000
000000010000000
000000010000000
000100010000000
111100000000000
000000000000000
000000000000000
000000010000000