000001111111000
000000000001000
000000000001000
000000000000000
000000000000000
000000000000000
000100000000000
000011000000000
000001100000010
000000100011100
000000100000000
000000100000000
000000100000000
000000000000000
111000000000000
000000000000000
000000000111000
000000001000000
000000000000000
100010001000000